2 0 4 0 3 1 3 3 3 3 3 3 0 0 0 0
2 0 4 0 3 1 1 1 1 1 1 3 0 0 0 0
2 0 4 0 0 3 3 3 3 3 1 1 3 3 3 3
2 0 4 0 0 0 4 4 4 4 3 1 1 1 1 1
2 0 4 0 0 0 4 0 0 0 0 3 3 3 3 1
2 0 4 0 0 0 4 0 0 0 0 0 0 0 0 3
2 0 4 4 4 4 4 4 4 4 4 4 4 4 0 0
2 0 4 0 0 0 0 0 0 0 0 0 0 4 0 0
2 5 4 0 0 1 1 1 1 1 0 0 0 4 0 5
2 5 4 0 0 1 1 1 1 1 1 0 0 4 0 5
2 5 5 0 0 0 1 1 1 1 0 0 0 4 4 5
2 2 2 2 2 2 2 2 2 2 2 2 2 2 2 2